{
  "start":
  {
    "level":  [
                [ 1,  1,  1,  1,  1,  1,  1,  1,  1,  1],
                [ 1,  0,  0,  0,  0,  0,  0,  0,  0,  1],
                [ 1,  0,  0,  0,  0,  0,  0,  0,  0,  1],
                [ 1,  0,  0,  0,  0,  0,  0,  0,  0,  1],
                [ 1,  0,  0,  0,  0,  0,  0,  0,  0,  1],
                [ 1,  0,  0,  0,  0,  0,  0,  0,  0,  1],
                [ 1,  0,  0,  0,  0,  0,  0,  0,  0,  1],
                [ 1,  0,  0,  0,  0,  0,  0,  0,  0,  1],
                [ 1,  0,  0,  0,  0,  0,  0,  0,  0,  1],
                [ 1,  1,  1,  1,  1,  1,  1,  1,  1,  1]
              ],
              
    "up": "none",
    "right": "none",
    "down": "none",
    "left": "none"
  }

  
  
}
