{
  "start":
  {
    "level":  [
                [ 1,  1,  1,  1,  1,  1,  1,  1,  1,  1, 1,  1,  1,  1,  1,  1,  1,  1,  1,  1],
                [ 1,  2,  3,  4,  5,  6,  7,  8,  9,  0, 0,  0,  0,  0,  0,  0,  0,  0,  0,  1],
                [ 1, 10, 11, 12, 13, 14, 15, 16, 17,  0, 0,  0,  0,  0,  0,  0,  0,  0,  0,  1],
                [ 1, 18, 19,  0,  0,  0,  0,  0,  0,  0, 0,  0,  0,  0,  0,  0,  0,  0,  0,  1],
                [ 1,  0,  0,  0,  0,  0,  0,  0,  0,  0, 0,  0,  0,  0,  0,  0,  0,  0,  0,  1],
                [ 1,  0,  0,  0,  0,  0,  0,  0,  0,  0, 0,  0,  0,  0,  0,  0,  0,  0,  0,  1],
                [ 1,  0,  0,  0,  0,  0,  0,  0,  0,  0, 0,  0,  0,  0,  0,  0,  0,  0,  0,  1],
                [ 1,  0,  0,  0,  0,  0,  0,  0,  0,  0, 0,  0,  0,  0,  0,  0,  0,  0,  0,  1],
                [ 1,  0,  0,  0,  0,  0,  0,  0,  0,  0, 0,  0,  0,  0,  0,  0,  0,  0,  0,  1],
                [ 1,  0,  0,  0,  0,  0,  0,  0,  0,  0, 0,  0,  0,  0,  0,  0,  0,  0,  0,  1],
                [ 1,  0,  0,  0,  0,  0,  0,  0,  0,  0, 0,  0,  0,  0,  0,  0,  0,  0,  0,  1],
                [ 1,  0,  0,  0,  0,  0,  0,  0,  0,  0, 0,  0,  0,  0,  0,  0,  0,  0,  0,  1],
                [ 1,  0,  0,  0,  0,  0,  0,  0,  0,  0, 0,  0,  0,  0,  0,  0,  0,  0,  0,  1],
                [ 1,  0,  0,  0,  0,  0,  0,  0,  0,  0, 0,  0,  0,  0,  0,  0,  0,  0,  0,  1],
                [ 1,  0,  0,  0,  0,  0,  0,  0,  0,  0, 0,  0,  0,  0,  0,  0,  0,  0,  0,  1],
                [ 1,  0,  0,  0,  0,  0,  0,  0,  0,  0, 0,  0,  0,  0,  0,  0,  0,  0,  0,  1],
                [ 1,  0,  0,  0,  0,  0,  0,  0,  0,  0, 0,  0,  0,  0,  0,  0,  0,  0,  0,  1],
                [ 1,  0,  0,  0,  0,  0,  0,  0,  0,  0, 0,  0,  0,  0,  0,  0,  0,  0,  0,  1],
                [ 1,  0,  0,  0,  0,  0,  0,  0,  0,  0, 0,  0,  0,  0,  0,  0,  0,  0,  0,  1],
                [ 1,  1,  1,  1,  1,  1,  1,  1,  1,  1, 1,  1,  1,  1,  1,  1,  1,  1,  1,  1]
              ],    
    "up": "none",
    "right": "none",
    "down": "none",
    "left": "none"
  }

  
  
}
