{
  "start":
  {
    "level":  [
                [ 0,  0,  0, 44, 45, 46,  0,  0,  0,  0, 0,  0,  0,  0,  0,  0],
                [ 1,  1, 47, 48, 49, 50, 51,  1,  1,  1, 1,  1,  1,  1,  1,  1],
                [ 9,  9, 52, 53, 54, 55, 56,  9,  9,  9,86, 30, 31, 32, 32, 32],
                [ 2,  2, 57, 58, 59, 60, 61,  2,  2,  2, 2, 33, 34, 35, 39, 39],
                [ 2,  2, 62, 63, 64, 65, 66,  2,  2,  2, 7,  1, 36, 37, 38, 39],
                [ 2, 42,  2,  2,  2,  2,  2,  2,  2,  2, 2,  2,  2,  2, 40, 41],
                [ 7,  1,  8,  2,  2,  2,  2,  2,  2,  2, 2,  2,  2,  2,  2,  2],
                [ 2,  2,  2,  2,  2,  2, 20, 21, 21, 21,21, 21, 21, 22,  2,  2],
                [ 2,  2,  2,  2,  2,  2, 23,  3,  3,  3, 3,  3,  3, 24,  2,  2],
                [67, 68,  2,  2,  2,  2, 23,  3,  3,  3, 3,  3,  3, 24,  2,  2],
                [69, 70, 71,  2,  2,  2, 23,  3,  3,  3, 3,  3,  3, 24,  2,  2],
                [72, 73, 74,  2,  2,  2, 23,  3,  3,  3, 3,  3,  3, 24,  2,  2],
                [75, 76, 77,  2,  2,  2, 25, 27, 28, 26,26, 26, 26, 29,  2,  2],
                [78, 79, 80,  2,  2,  2,  2,  2,  2,  2, 2,  2,  2,  2, 42,  2],
                [81, 82, 83,  2,  2,  2,  2,  2,  2,  2, 2,  2,  2,  7,  1,  8],
                [84, 85,  2,  2,  2,  2,  2,  2,  2,  2, 2,  2,  2,  2,  2,  2],
                [ 0,0,0,0,0,0,0,0,0,0,0,0,0,0,0,0]
              ],    
    "up": "none",
    "right": "none",
    "down": "none",
    "left": "none"
  }

  
  
}
